# # # # # # # # # # # # # #
# . . . . . . . . . . . . #
# # # # # # # # # # # # . #
# . . . . . . . . . . # . #
# . # # # # # # # # . # . #
# . # . . . . . . # . # . #
# . # . # # # # . # . # . #
# . # . # # . # . # . # . #
# . # . # . # # . # . # . #
# . # . # . . . . # . # . #
# . # . # # # # # # . # . #
# . # . . . . . . . . # . #
# . # # # # # # # # # # . #
# . . . . . . . . . . . . #
# # # # # # # # # # # # # #