# # # # # # # # # # # # # # # # # # # # # # # # # # # # # # # #
# ~ . . # . . . . . . # . # . . ~ . . # . . . . . . # . # . . #
# # # # # . # # # . . . . # . # # # # # . # # # . . . . # . # #
# . . . . ~ ~ ~ . . . # . . . * . . . . ~ ~ ~ . . . # . . . * #
# . # # # ~ # . # . # . # . # * . # # # ~ # . # . # . # . # * #
# . # . # ~ # . # . # . # . # * . # . # ~ # . # . # . # . # * #
# . # . # ~ # . # . . # # . # . * # . # ~ # . # . . # # . # . #
# . # . . ~ # . # # . # . # . * . # . . ~ # . # # . # . # . . #
# * . . # # # . ~ # . . * . . # * . . # # # . ~ # . . . . . # #
# * * * * . . . # # ~ # # . . . * * * * . . . # # . # # . . . #
# # # # . # . . . # . # . . # . # # # . # . . . # . # . . # . #
# . . . . # . # . . . # # . # . * ~ . . # . # . . . # # . # . #
# . # . # ~ # . # . # . # . # * * * . # # # . ~ # . . . . . # #
# . # . # ~ # . # . . # # . # . * . . # # # . ~ # . . . . . # #
# . # . . ~ # . # # * # . # . . . # . # ~ # . # . . # # . # . #
# * . . # # # . ~ # . . . . . # . # . # ~ # . # . # . # . # * #
# * * * * . . . # # . # # . . . . # # # ~ # . # . # . # . # * #
# # # # . # . . . # . # . . # . . . . . ~ ~ ~ . . . # . . . * #
# . . . . # . # . . . # # . # . # # # # . # # # . . . . # . # #
# . # # . # . # . # . . . . . . ~ . . # . . . . . . # . # . . #
# # # # # # # # # # # # # # # # # # # # # # # # # # # # # # # #