# # # # # # # # # # # # # # # # # # # # # # # # # # # # # # # #
# ~ . . # . . . . . . # . # . . ~ . . # . . . . . . # . # . . #
# # # # # . # # # . . . . # . # # # # # . # # # . . . . # . # #
# . . . . ~ ~ ~ . . . # . . . * . . . . ~ ~ ~ . . . # . . . * #
# . # # # ~ # . # . # . # . # * . # # # ~ # . # . # . # . # * #
# . # . # ~ # . # . # . # . # * . # . # ~ # . # . # . # . # * #
# . # . # ~ # . # . . # # . # . . # . # ~ # . # . . # # . # . #
# . # . . ~ # . # # . # . # . . . # . . ~ # . # # . # . # . . #
# * . . # # # . ~ # . . . . . # * . . # # # . ~ # . . . . . # #
# * * * * . . . # # . # # . . . * * * * . . . # # . # # . . . #
# # # # . # . . . # . # . . # . # # # . # . . . # . # . . # . #
# . . . . # . # . . . # # . # . . . . . # . # . . . # # . # . #
# . # . # ~ # . # . # . # . # * * . . # # # . ~ # . . . . . # #
# . # . # ~ # . # . . # # . # . * . . # # # . ~ # . . . . . # #
# . # . . ~ # . # # . # . # . . . # . # ~ # . # . . # # . # . #
# * . . # # # . ~ # . . . . . # . # . # ~ # . # . # . # . # * #
# * * * * . . . # # . # # . . . . # # # ~ # . # . # . # . # * #
# # # # . # . . . # . # . . # . . . . . ~ ~ ~ . . . # . . . * #
# . . . . # . # . . . # # . # . # # # # . # # # . . . . # . # #
# . # # . # . # . # . . . . . . ~ . . # . . . . . . # . # . . #
# # # # # # # # # # # # # # # # # # # # # # # # # # # # # # # #